10
10
TTTTTTTTTT
T........T
T........T
TTTTTT...T
T........T
T.....TTTT
T........T
T........T
T........T
TTTTTTTTTT