20
20
TTTTTTTTTTTTTTTTTTTT
T..................T
T...TTTTTTTTTTTT...T
T...TTTTTTTTTTTT...T
T..................T
T..................T
T...TTTTTTTTTTTT...T
T...TTTTTTTTTTTT...T
T..................T
T..................T
T...TTTTTTTTTTTT...T
T...TTTTTTTTTTTT...T
T..................T
T..................T
T...TTTTTTTTTTTT...T
T...TTTTTTTTTTTT...T
T..................T
T...TTTTTTTTTTTT...T
T..................T
TTTTTTTTTTTTTTTTTTTT