20
20
TTTTTTTTTTTTTTTTTTTT
T..................T
T..................T
T..................T
TTTTTTTTTT.........T
T..................T
T..................T
TTT................T
T..................T
T.........TTTTTTTTTT
T.........T........T
T.........T........T
T..................T
T.........T........T
T.........T........T
T.......TTT........T
T..................T
T.........TTTTT....T
T...........T......T
TTTTTTTTTTTTTTTTTTTT