30
30
TTTTTTTTTTTTTTTTTTTTTTTTTTTTTT
T............................T
T............................T
T.........T..................T
T.........T..................T
T.........T..................T
T.........T..................T
T.........T..................T
TTTTTTTTTTT..................T
T............................T
T............................T
T............................T
T............................T
T..........TTTTTTTT..........T
T..............T.............T
T..............T.............T
T..............T....TTTT.....T
T..............T.......T.....T
T..............T.......T.....T
T..............TTTTTTTTT.....T
T............................T
T............................T
T..................T.........T
T...................T........T
T..........T.........T.......T
T..........T..........T......T
T..........T...........T.....T
T..........T............T....T
T..........T.............T...T
TTTTTTTTTTTTTTTTTTTTTTTTTTTTTT